"filename", "language", "Python", "CSV", "comment", "blank", "total"
"c:\Users\MichaelPerkins\OneDrive - Nomi Health, Inc\Desktop\Projects\financial_dashboard_v3\.history\compile_scripts_20230317120330.py", "Python", 0, 0, 0, 1, 1
"c:\Users\MichaelPerkins\OneDrive - Nomi Health, Inc\Desktop\Projects\financial_dashboard_v3\.history\compile_scripts_20230317120933.py", "Python", 20, 0, 21, 4, 45
"c:\Users\MichaelPerkins\OneDrive - Nomi Health, Inc\Desktop\Projects\financial_dashboard_v3\.history\compile_scripts_20230317121402.py", "Python", 23, 0, 26, 4, 53
"c:\Users\MichaelPerkins\OneDrive - Nomi Health, Inc\Desktop\Projects\financial_dashboard_v3\.history\compile_scripts_20230317121523.py", "Python", 22, 0, 25, 5, 52
"c:\Users\MichaelPerkins\OneDrive - Nomi Health, Inc\Desktop\Projects\financial_dashboard_v3\.history\compile_scripts_20230317121758.py", "Python", 22, 0, 26, 4, 52
"c:\Users\MichaelPerkins\OneDrive - Nomi Health, Inc\Desktop\Projects\financial_dashboard_v3\.history\compile_scripts_20230317121812.py", "Python", 28, 0, 30, 6, 64
"c:\Users\MichaelPerkins\OneDrive - Nomi Health, Inc\Desktop\Projects\financial_dashboard_v3\.history\compile_scripts_20230317121840.py", "Python", 29, 0, 30, 6, 65
"c:\Users\MichaelPerkins\OneDrive - Nomi Health, Inc\Desktop\Projects\financial_dashboard_v3\.history\compile_scripts_20230317121915.py", "Python", 28, 0, 29, 6, 63
"c:\Users\MichaelPerkins\OneDrive - Nomi Health, Inc\Desktop\Projects\financial_dashboard_v3\.history\compile_scripts_20230317123213.py", "Python", 22, 0, 13, 9, 44
"c:\Users\MichaelPerkins\OneDrive - Nomi Health, Inc\Desktop\Projects\financial_dashboard_v3\.history\compile_scripts_20230317123251.py", "Python", 25, 0, 13, 9, 47
"c:\Users\MichaelPerkins\OneDrive - Nomi Health, Inc\Desktop\Projects\financial_dashboard_v3\.history\compile_scripts_20230317123402.py", "Python", 25, 0, 13, 9, 47
"c:\Users\MichaelPerkins\OneDrive - Nomi Health, Inc\Desktop\Projects\financial_dashboard_v3\.history\compile_scripts_20230317123532.py", "Python", 24, 0, 7, 6, 37
"c:\Users\MichaelPerkins\OneDrive - Nomi Health, Inc\Desktop\Projects\financial_dashboard_v3\.history\compile_scripts_20230317123951.py", "Python", 25, 0, 7, 7, 39
"c:\Users\MichaelPerkins\OneDrive - Nomi Health, Inc\Desktop\Projects\financial_dashboard_v3\.history\compile_scripts_20230317124255.py", "Python", 26, 0, 16, 8, 50
"c:\Users\MichaelPerkins\OneDrive - Nomi Health, Inc\Desktop\Projects\financial_dashboard_v3\.history\compile_scripts_20230317124308.py", "Python", 26, 0, 16, 8, 50
"c:\Users\MichaelPerkins\OneDrive - Nomi Health, Inc\Desktop\Projects\financial_dashboard_v3\.history\compile_scripts_20230317124827.py", "Python", 26, 0, 16, 8, 50
"c:\Users\MichaelPerkins\OneDrive - Nomi Health, Inc\Desktop\Projects\financial_dashboard_v3\.history\compile_scripts_20230317130126.py", "Python", 33, 0, 18, 12, 63
"c:\Users\MichaelPerkins\OneDrive - Nomi Health, Inc\Desktop\Projects\financial_dashboard_v3\.history\compile_scripts_20230317130144.py", "Python", 33, 0, 18, 12, 63
"c:\Users\MichaelPerkins\OneDrive - Nomi Health, Inc\Desktop\Projects\financial_dashboard_v3\.history\compile_scripts_20230317131325.py", "Python", 33, 0, 18, 12, 63
"c:\Users\MichaelPerkins\OneDrive - Nomi Health, Inc\Desktop\Projects\financial_dashboard_v3\.history\compile_scripts_20230317131751.py", "Python", 36, 0, 18, 12, 66
"c:\Users\MichaelPerkins\OneDrive - Nomi Health, Inc\Desktop\Projects\financial_dashboard_v3\.history\compile_scripts_20230317131824.py", "Python", 36, 0, 18, 12, 66
"c:\Users\MichaelPerkins\OneDrive - Nomi Health, Inc\Desktop\Projects\financial_dashboard_v3\.history\compile_scripts_20230317132617.py", "Python", 36, 0, 18, 12, 66
"c:\Users\MichaelPerkins\OneDrive - Nomi Health, Inc\Desktop\Projects\financial_dashboard_v3\.history\compile_scripts_20230317133903.py", "Python", 37, 0, 18, 12, 67
"c:\Users\MichaelPerkins\OneDrive - Nomi Health, Inc\Desktop\Projects\financial_dashboard_v3\.history\compile_scripts_20230317134652.py", "Python", 41, 0, 10, 11, 62
"c:\Users\MichaelPerkins\OneDrive - Nomi Health, Inc\Desktop\Projects\financial_dashboard_v3\.history\compile_scripts_20230317135129.py", "Python", 41, 0, 10, 11, 62
"c:\Users\MichaelPerkins\OneDrive - Nomi Health, Inc\Desktop\Projects\financial_dashboard_v3\.history\compile_scripts_20230317145326.py", "Python", 42, 0, 17, 10, 69
"c:\Users\MichaelPerkins\OneDrive - Nomi Health, Inc\Desktop\Projects\financial_dashboard_v3\.history\compile_scripts_20230317145436.py", "Python", 42, 0, 17, 10, 69
"c:\Users\MichaelPerkins\OneDrive - Nomi Health, Inc\Desktop\Projects\financial_dashboard_v3\.history\compile_scripts_20230317145618.py", "Python", 41, 0, 8, 6, 55
"c:\Users\MichaelPerkins\OneDrive - Nomi Health, Inc\Desktop\Projects\financial_dashboard_v3\.history\compile_scripts_20230317145924.py", "Python", 33, 0, 21, 12, 66
"c:\Users\MichaelPerkins\OneDrive - Nomi Health, Inc\Desktop\Projects\financial_dashboard_v3\.history\compile_scripts_20230317145932.py", "Python", 33, 0, 21, 12, 66
"c:\Users\MichaelPerkins\OneDrive - Nomi Health, Inc\Desktop\Projects\financial_dashboard_v3\.history\compile_scripts_20230317150043.py", "Python", 30, 0, 20, 10, 60
"c:\Users\MichaelPerkins\OneDrive - Nomi Health, Inc\Desktop\Projects\financial_dashboard_v3\.history\compile_scripts_20230317150603.py", "Python", 39, 0, 7, 7, 53
"c:\Users\MichaelPerkins\OneDrive - Nomi Health, Inc\Desktop\Projects\financial_dashboard_v3\.history\compile_scripts_20230317150607.py", "Python", 39, 0, 7, 7, 53
"c:\Users\MichaelPerkins\OneDrive - Nomi Health, Inc\Desktop\Projects\financial_dashboard_v3\.history\compile_scripts_20230317150626.py", "Python", 42, 0, 7, 8, 57
"c:\Users\MichaelPerkins\OneDrive - Nomi Health, Inc\Desktop\Projects\financial_dashboard_v3\.history\compile_scripts_20230317150701.py", "Python", 42, 0, 19, 10, 71
"c:\Users\MichaelPerkins\OneDrive - Nomi Health, Inc\Desktop\Projects\financial_dashboard_v3\.history\compile_scripts_20230317152339.py", "Python", 43, 0, 20, 10, 73
"c:\Users\MichaelPerkins\OneDrive - Nomi Health, Inc\Desktop\Projects\financial_dashboard_v3\.history\compile_scripts_20230317152408.py", "Python", 43, 0, 20, 10, 73
"c:\Users\MichaelPerkins\OneDrive - Nomi Health, Inc\Desktop\Projects\financial_dashboard_v3\.history\compile_scripts_20230317152820.py", "Python", 44, 0, 20, 10, 74
"c:\Users\MichaelPerkins\OneDrive - Nomi Health, Inc\Desktop\Projects\financial_dashboard_v3\.history\compile_scripts_20230320093727.py", "Python", 44, 0, 20, 10, 74
"c:\Users\MichaelPerkins\OneDrive - Nomi Health, Inc\Desktop\Projects\financial_dashboard_v3\.history\compile_scripts_20230320102002.py", "Python", 46, 0, 20, 10, 76
"c:\Users\MichaelPerkins\OneDrive - Nomi Health, Inc\Desktop\Projects\financial_dashboard_v3\.history\compile_scripts_20230320102222.py", "Python", 46, 0, 20, 10, 76
"c:\Users\MichaelPerkins\OneDrive - Nomi Health, Inc\Desktop\Projects\financial_dashboard_v3\.history\compile_scripts_20230320104028.py", "Python", 47, 0, 20, 10, 77
"c:\Users\MichaelPerkins\OneDrive - Nomi Health, Inc\Desktop\Projects\financial_dashboard_v3\.history\compile_scripts_20230320111421.py", "Python", 49, 0, 20, 10, 79
"c:\Users\MichaelPerkins\OneDrive - Nomi Health, Inc\Desktop\Projects\financial_dashboard_v3\.history\compile_scripts_20230320111704.py", "Python", 49, 0, 20, 10, 79
"c:\Users\MichaelPerkins\OneDrive - Nomi Health, Inc\Desktop\Projects\financial_dashboard_v3\.history\compile_scripts_20230320113319.py", "Python", 53, 0, 20, 10, 83
"c:\Users\MichaelPerkins\OneDrive - Nomi Health, Inc\Desktop\Projects\financial_dashboard_v3\.history\compile_scripts_20230320114715.py", "Python", 54, 0, 20, 10, 84
"c:\Users\MichaelPerkins\OneDrive - Nomi Health, Inc\Desktop\Projects\financial_dashboard_v3\.history\compile_scripts_20230320120936.py", "Python", 54, 0, 20, 10, 84
"c:\Users\MichaelPerkins\OneDrive - Nomi Health, Inc\Desktop\Projects\financial_dashboard_v3\.history\compile_scripts_20230320121812.py", "Python", 56, 0, 20, 10, 86
"c:\Users\MichaelPerkins\OneDrive - Nomi Health, Inc\Desktop\Projects\financial_dashboard_v3\.history\compile_scripts_20230320132339.py", "Python", 60, 0, 20, 10, 90
"c:\Users\MichaelPerkins\OneDrive - Nomi Health, Inc\Desktop\Projects\financial_dashboard_v3\.history\compile_scripts_20230320132526.py", "Python", 61, 0, 20, 10, 91
"c:\Users\MichaelPerkins\OneDrive - Nomi Health, Inc\Desktop\Projects\financial_dashboard_v3\.history\compiled_scripts\output_2023-03-17_13-01-45_20230317130144.py", "Python", 11, 0, 0, 6, 17
"c:\Users\MichaelPerkins\OneDrive - Nomi Health, Inc\Desktop\Projects\financial_dashboard_v3\.history\compiled_scripts\output_2023-03-17_13-01-45_20230317130206.py", "Python", 13, 0, 0, 6, 19
"c:\Users\MichaelPerkins\OneDrive - Nomi Health, Inc\Desktop\Projects\financial_dashboard_v3\.history\compiled_scripts\output_2023-03-17_13-01-45_20230317130637.py", "Python", 11, 0, 0, 5, 16
"c:\Users\MichaelPerkins\OneDrive - Nomi Health, Inc\Desktop\Projects\financial_dashboard_v3\.history\compiled_scripts\output_2023-03-17_13-39-05_20230317133904.py", "Python", 62, 0, 20, 24, 106
"c:\Users\MichaelPerkins\OneDrive - Nomi Health, Inc\Desktop\Projects\financial_dashboard_v3\.history\compiled_scripts\output_2023-03-17_13-39-05_20230317133918.py", "Python", 62, 0, 20, 24, 106
"c:\Users\MichaelPerkins\OneDrive - Nomi Health, Inc\Desktop\Projects\financial_dashboard_v3\.history\compiled_scripts\output_2023-03-17_14-03-57_20230317140356.py", "Python", 64, 0, 21, 24, 109
"c:\Users\MichaelPerkins\OneDrive - Nomi Health, Inc\Desktop\Projects\financial_dashboard_v3\.history\compiled_scripts\output_2023-03-17_14-03-57_20230317145327.py", "Python", 64, 0, 21, 23, 108
"c:\Users\MichaelPerkins\OneDrive - Nomi Health, Inc\Desktop\Projects\financial_dashboard_v3\.history\scripts\_main__20230320114507.py", "Python", 40, 0, 8, 11, 59
"c:\Users\MichaelPerkins\OneDrive - Nomi Health, Inc\Desktop\Projects\financial_dashboard_v3\.history\scripts\_main__20230320121645.py", "Python", 46, 0, 10, 14, 70
"c:\Users\MichaelPerkins\OneDrive - Nomi Health, Inc\Desktop\Projects\financial_dashboard_v3\.history\scripts\_main__20230320121650.py", "Python", 46, 0, 10, 15, 71
"c:\Users\MichaelPerkins\OneDrive - Nomi Health, Inc\Desktop\Projects\financial_dashboard_v3\.history\scripts\_main__20230320121724.py", "Python", 46, 0, 10, 13, 69
"c:\Users\MichaelPerkins\OneDrive - Nomi Health, Inc\Desktop\Projects\financial_dashboard_v3\.history\scripts\_main__20230320132056.py", "Python", 51, 0, 10, 14, 75
"c:\Users\MichaelPerkins\OneDrive - Nomi Health, Inc\Desktop\Projects\financial_dashboard_v3\.history\scripts\_main__20230320132121.py", "Python", 51, 0, 10, 14, 75
"c:\Users\MichaelPerkins\OneDrive - Nomi Health, Inc\Desktop\Projects\financial_dashboard_v3\.history\scripts\clean_actuals_20230320131154.py", "Python", 53, 0, 23, 13, 89
"c:\Users\MichaelPerkins\OneDrive - Nomi Health, Inc\Desktop\Projects\financial_dashboard_v3\.history\scripts\clean_actuals_20230320131732.py", "Python", 55, 0, 24, 19, 98
"c:\Users\MichaelPerkins\OneDrive - Nomi Health, Inc\Desktop\Projects\financial_dashboard_v3\.history\scripts\clean_actuals_20230320132010.py", "Python", 57, 0, 24, 19, 100
"c:\Users\MichaelPerkins\OneDrive - Nomi Health, Inc\Desktop\Projects\financial_dashboard_v3\.history\scripts\clean_actuals_20230320132026.py", "Python", 58, 0, 24, 20, 102
"c:\Users\MichaelPerkins\OneDrive - Nomi Health, Inc\Desktop\Projects\financial_dashboard_v3\.history\scripts\clean_actuals_20230320132037.py", "Python", 58, 0, 24, 20, 102
"c:\Users\MichaelPerkins\OneDrive - Nomi Health, Inc\Desktop\Projects\financial_dashboard_v3\.history\scripts\clean_actuals_20230320134813.py", "Python", 58, 0, 24, 20, 102
"c:\Users\MichaelPerkins\OneDrive - Nomi Health, Inc\Desktop\Projects\financial_dashboard_v3\.history\scripts\clean_actuals_fte_20230320131731.py", "Python", 55, 0, 24, 19, 98
"c:\Users\MichaelPerkins\OneDrive - Nomi Health, Inc\Desktop\Projects\financial_dashboard_v3\.history\scripts\clean_actuals_fte_20230320131954.py", "Python", 24, 0, 5, 6, 35
"c:\Users\MichaelPerkins\OneDrive - Nomi Health, Inc\Desktop\Projects\financial_dashboard_v3\.history\scripts\clean_actuals_fte_20230320131959.py", "Python", 20, 0, 5, 6, 31
"c:\Users\MichaelPerkins\OneDrive - Nomi Health, Inc\Desktop\Projects\financial_dashboard_v3\.history\scripts\clean_allocation_sheet_20230320113233.py", "Python", 9, 0, 5, 3, 17
"c:\Users\MichaelPerkins\OneDrive - Nomi Health, Inc\Desktop\Projects\financial_dashboard_v3\.history\scripts\clean_allocation_sheet_20230320121503.py", "Python", 47, 0, 19, 13, 79
"c:\Users\MichaelPerkins\OneDrive - Nomi Health, Inc\Desktop\Projects\financial_dashboard_v3\.history\scripts\clean_allocation_sheet_20230320121537.py", "Python", 48, 0, 19, 13, 80
"c:\Users\MichaelPerkins\OneDrive - Nomi Health, Inc\Desktop\Projects\financial_dashboard_v3\.history\scripts\clean_allocation_sheet_20230320121633.py", "Python", 47, 0, 19, 13, 79
"c:\Users\MichaelPerkins\OneDrive - Nomi Health, Inc\Desktop\Projects\financial_dashboard_v3\.history\scripts\clean_allocation_sheet_20230320122507.py", "Python", 44, 0, 20, 12, 76
"c:\Users\MichaelPerkins\OneDrive - Nomi Health, Inc\Desktop\Projects\financial_dashboard_v3\.history\scripts\clean_allocation_sheet_20230320122800.py", "Python", 47, 0, 22, 12, 81
"c:\Users\MichaelPerkins\OneDrive - Nomi Health, Inc\Desktop\Projects\financial_dashboard_v3\.history\scripts\clean_allocation_sheet_20230320123103.py", "Python", 59, 0, 27, 11, 97
"c:\Users\MichaelPerkins\OneDrive - Nomi Health, Inc\Desktop\Projects\financial_dashboard_v3\.history\scripts\clean_allocation_sheet_20230320123246.py", "Python", 60, 0, 27, 12, 99
"c:\Users\MichaelPerkins\OneDrive - Nomi Health, Inc\Desktop\Projects\financial_dashboard_v3\.history\scripts\clean_allocation_sheet_20230320123328.py", "Python", 60, 0, 28, 13, 101
"c:\Users\MichaelPerkins\OneDrive - Nomi Health, Inc\Desktop\Projects\financial_dashboard_v3\.history\scripts\clean_allocation_sheet_20230320123457.py", "Python", 60, 0, 28, 13, 101
"c:\Users\MichaelPerkins\OneDrive - Nomi Health, Inc\Desktop\Projects\financial_dashboard_v3\.history\scripts\clean_allocation_sheet_20230320123502.py", "Python", 60, 0, 28, 13, 101
"c:\Users\MichaelPerkins\OneDrive - Nomi Health, Inc\Desktop\Projects\financial_dashboard_v3\.history\scripts\clean_allocation_sheet_20230320123522.py", "Python", 60, 0, 28, 13, 101
"c:\Users\MichaelPerkins\OneDrive - Nomi Health, Inc\Desktop\Projects\financial_dashboard_v3\.history\scripts\clean_allocation_sheet_20230320123540.py", "Python", 60, 0, 28, 13, 101
"c:\Users\MichaelPerkins\OneDrive - Nomi Health, Inc\Desktop\Projects\financial_dashboard_v3\.history\scripts\clean_allocation_sheet_20230320123837.py", "Python", 60, 0, 27, 12, 99
"c:\Users\MichaelPerkins\OneDrive - Nomi Health, Inc\Desktop\Projects\financial_dashboard_v3\.history\scripts\clean_allocation_sheet_20230320123838.py", "Python", 60, 0, 27, 12, 99
"c:\Users\MichaelPerkins\OneDrive - Nomi Health, Inc\Desktop\Projects\financial_dashboard_v3\.history\scripts\clean_allocation_sheet_20230320123908.py", "Python", 60, 0, 27, 12, 99
"c:\Users\MichaelPerkins\OneDrive - Nomi Health, Inc\Desktop\Projects\financial_dashboard_v3\.history\scripts\clean_allocation_sheet_20230320124056.py", "Python", 61, 0, 27, 12, 100
"c:\Users\MichaelPerkins\OneDrive - Nomi Health, Inc\Desktop\Projects\financial_dashboard_v3\.history\scripts\clean_allocation_sheet_20230320124113.py", "Python", 62, 0, 27, 12, 101
"c:\Users\MichaelPerkins\OneDrive - Nomi Health, Inc\Desktop\Projects\financial_dashboard_v3\.history\scripts\clean_allocation_sheet_20230320124213.py", "Python", 62, 0, 27, 12, 101
"c:\Users\MichaelPerkins\OneDrive - Nomi Health, Inc\Desktop\Projects\financial_dashboard_v3\.history\scripts\clean_allocation_sheet_20230320124348.py", "Python", 63, 0, 28, 12, 103
"c:\Users\MichaelPerkins\OneDrive - Nomi Health, Inc\Desktop\Projects\financial_dashboard_v3\.history\scripts\clean_allocation_sheet_20230320124459.py", "Python", 62, 0, 27, 12, 101
"c:\Users\MichaelPerkins\OneDrive - Nomi Health, Inc\Desktop\Projects\financial_dashboard_v3\.history\scripts\clean_allocation_sheet_20230320124510.py", "Python", 62, 0, 27, 12, 101
"c:\Users\MichaelPerkins\OneDrive - Nomi Health, Inc\Desktop\Projects\financial_dashboard_v3\.history\scripts\clean_allocation_sheet_20230320131134.py", "Python", 53, 0, 23, 13, 89
"c:\Users\MichaelPerkins\OneDrive - Nomi Health, Inc\Desktop\Projects\financial_dashboard_v3\.history\scripts\clean_allocation_sheet_20230320131155.py", "Python", 53, 0, 23, 13, 89
"c:\Users\MichaelPerkins\OneDrive - Nomi Health, Inc\Desktop\Projects\financial_dashboard_v3\.history\scripts\clean_allocation_sheet_20230320133058.py", "Python", 59, 0, 24, 14, 97
"c:\Users\MichaelPerkins\OneDrive - Nomi Health, Inc\Desktop\Projects\financial_dashboard_v3\.history\scripts\clean_allocation_sheet_20230320133202.py", "Python", 53, 0, 22, 12, 87
"c:\Users\MichaelPerkins\OneDrive - Nomi Health, Inc\Desktop\Projects\financial_dashboard_v3\.history\scripts\clean_allocation_sheet_20230320133348.py", "Python", 60, 0, 25, 15, 100
"c:\Users\MichaelPerkins\OneDrive - Nomi Health, Inc\Desktop\Projects\financial_dashboard_v3\.history\scripts\clean_allocation_sheet_20230320133422.py", "Python", 60, 0, 25, 15, 100
"c:\Users\MichaelPerkins\OneDrive - Nomi Health, Inc\Desktop\Projects\financial_dashboard_v3\.history\scripts\clean_allocation_sheet_20230320133515.py", "Python", 61, 0, 25, 16, 102
"c:\Users\MichaelPerkins\OneDrive - Nomi Health, Inc\Desktop\Projects\financial_dashboard_v3\.history\scripts\clean_allocation_sheet_20230320133615.py", "Python", 54, 0, 24, 14, 92
"c:\Users\MichaelPerkins\OneDrive - Nomi Health, Inc\Desktop\Projects\financial_dashboard_v3\.history\scripts\clean_allocation_sheet_20230320133731.py", "Python", 53, 0, 24, 14, 91
"c:\Users\MichaelPerkins\OneDrive - Nomi Health, Inc\Desktop\Projects\financial_dashboard_v3\.history\scripts\clean_allocation_sheet_20230320133806.py", "Python", 53, 0, 24, 14, 91
"c:\Users\MichaelPerkins\OneDrive - Nomi Health, Inc\Desktop\Projects\financial_dashboard_v3\.history\scripts\clean_allocation_sheet_20230320133845.py", "Python", 53, 0, 25, 14, 92
"c:\Users\MichaelPerkins\OneDrive - Nomi Health, Inc\Desktop\Projects\financial_dashboard_v3\.history\scripts\clean_allocation_sheet_20230320133940.py", "Python", 54, 0, 26, 15, 95
"c:\Users\MichaelPerkins\OneDrive - Nomi Health, Inc\Desktop\Projects\financial_dashboard_v3\.history\scripts\clean_allocation_sheet_20230320134017.py", "Python", 55, 0, 27, 15, 97
"c:\Users\MichaelPerkins\OneDrive - Nomi Health, Inc\Desktop\Projects\financial_dashboard_v3\.history\scripts\clean_allocation_sheet_20230320134056.py", "Python", 54, 0, 26, 14, 94
"c:\Users\MichaelPerkins\OneDrive - Nomi Health, Inc\Desktop\Projects\financial_dashboard_v3\.history\scripts\clean_allocation_sheet_20230320134432.py", "Python", 53, 0, 25, 15, 93
"c:\Users\MichaelPerkins\OneDrive - Nomi Health, Inc\Desktop\Projects\financial_dashboard_v3\.history\scripts\clean_allocation_sheet_20230320134502.py", "Python", 53, 0, 25, 15, 93
"c:\Users\MichaelPerkins\OneDrive - Nomi Health, Inc\Desktop\Projects\financial_dashboard_v3\.history\scripts\clean_allocation_sheet_20230320134503.py", "Python", 53, 0, 25, 15, 93
"c:\Users\MichaelPerkins\OneDrive - Nomi Health, Inc\Desktop\Projects\financial_dashboard_v3\.history\scripts\clean_data_20230320113233.py", "Python", 9, 0, 5, 3, 17
"c:\Users\MichaelPerkins\OneDrive - Nomi Health, Inc\Desktop\Projects\financial_dashboard_v3\.history\scripts\clean_data_20230320121439.py", "Python", 9, 0, 8, 4, 21
"c:\Users\MichaelPerkins\OneDrive - Nomi Health, Inc\Desktop\Projects\financial_dashboard_v3\.history\scripts\complete_data_import_20230317131517.py", "Python", 8, 0, 7, 1, 16
"c:\Users\MichaelPerkins\OneDrive - Nomi Health, Inc\Desktop\Projects\financial_dashboard_v3\.history\scripts\complete_data_import_20230317131756.py", "Python", 7, 0, 8, 1, 16
"c:\Users\MichaelPerkins\OneDrive - Nomi Health, Inc\Desktop\Projects\financial_dashboard_v3\.history\scripts\complete_data_import_20230317132551.py", "Python", 8, 0, 8, 2, 18
"c:\Users\MichaelPerkins\OneDrive - Nomi Health, Inc\Desktop\Projects\financial_dashboard_v3\.history\scripts\complete_data_import_20230317140124.py", "Python", 9, 0, 8, 2, 19
"c:\Users\MichaelPerkins\OneDrive - Nomi Health, Inc\Desktop\Projects\financial_dashboard_v3\.history\scripts\complete_data_import_20230317140216.py", "Python", 8, 0, 8, 2, 18
"c:\Users\MichaelPerkins\OneDrive - Nomi Health, Inc\Desktop\Projects\financial_dashboard_v3\.history\scripts\complete_data_import_20230317140327.py", "Python", 10, 0, 8, 2, 20
"c:\Users\MichaelPerkins\OneDrive - Nomi Health, Inc\Desktop\Projects\financial_dashboard_v3\.history\scripts\constants_20230320102542.py", "Python", 71, 0, 9, 12, 92
"c:\Users\MichaelPerkins\OneDrive - Nomi Health, Inc\Desktop\Projects\financial_dashboard_v3\.history\scripts\constants_20230320103931.py", "Python", 47, 0, 4, 3, 54
"c:\Users\MichaelPerkins\OneDrive - Nomi Health, Inc\Desktop\Projects\financial_dashboard_v3\.history\scripts\constants_20230320104227.py", "Python", 47, 0, 5, 3, 55
"c:\Users\MichaelPerkins\OneDrive - Nomi Health, Inc\Desktop\Projects\financial_dashboard_v3\.history\scripts\constants_20230320104736.py", "Python", 56, 0, 12, 5, 73
"c:\Users\MichaelPerkins\OneDrive - Nomi Health, Inc\Desktop\Projects\financial_dashboard_v3\.history\scripts\constants_20230320111043.py", "Python", 66, 0, 13, 8, 87
"c:\Users\MichaelPerkins\OneDrive - Nomi Health, Inc\Desktop\Projects\financial_dashboard_v3\.history\scripts\constants_20230320112812.py", "Python", 84, 0, 13, 13, 110
"c:\Users\MichaelPerkins\OneDrive - Nomi Health, Inc\Desktop\Projects\financial_dashboard_v3\.history\scripts\constants_20230320112823.py", "Python", 84, 0, 13, 12, 109
"c:\Users\MichaelPerkins\OneDrive - Nomi Health, Inc\Desktop\Projects\financial_dashboard_v3\.history\scripts\constants_20230320114632.py", "Python", 112, 0, 14, 13, 139
"c:\Users\MichaelPerkins\OneDrive - Nomi Health, Inc\Desktop\Projects\financial_dashboard_v3\.history\scripts\constants_20230320121527.py", "Python", 122, 0, 14, 14, 150
"c:\Users\MichaelPerkins\OneDrive - Nomi Health, Inc\Desktop\Projects\financial_dashboard_v3\.history\scripts\constants_20230320121622.py", "Python", 123, 0, 15, 15, 153
"c:\Users\MichaelPerkins\OneDrive - Nomi Health, Inc\Desktop\Projects\financial_dashboard_v3\.history\scripts\detect_environment_20230317121248.py", "Python", 4, 0, 4, 2, 10
"c:\Users\MichaelPerkins\OneDrive - Nomi Health, Inc\Desktop\Projects\financial_dashboard_v3\.history\scripts\detect_environment_20230317124531.py", "Python", 5, 0, 4, 3, 12
"c:\Users\MichaelPerkins\OneDrive - Nomi Health, Inc\Desktop\Projects\financial_dashboard_v3\.history\scripts\detect_environment_20230317124549.py", "Python", 8, 0, 4, 3, 15
"c:\Users\MichaelPerkins\OneDrive - Nomi Health, Inc\Desktop\Projects\financial_dashboard_v3\.history\scripts\detect_environment_20230317124643.py", "Python", 8, 0, 4, 3, 15
"c:\Users\MichaelPerkins\OneDrive - Nomi Health, Inc\Desktop\Projects\financial_dashboard_v3\.history\scripts\detect_environment_20230317124708.py", "Python", 8, 0, 4, 3, 15
"c:\Users\MichaelPerkins\OneDrive - Nomi Health, Inc\Desktop\Projects\financial_dashboard_v3\.history\scripts\detect_environment_20230317130600.py", "Python", 8, 0, 4, 4, 16
"c:\Users\MichaelPerkins\OneDrive - Nomi Health, Inc\Desktop\Projects\financial_dashboard_v3\.history\scripts\detect_environment_20230317130605.py", "Python", 8, 0, 4, 4, 16
"c:\Users\MichaelPerkins\OneDrive - Nomi Health, Inc\Desktop\Projects\financial_dashboard_v3\.history\scripts\detect_environment_20230317131351.py", "Python", 8, 0, 4, 4, 16
"c:\Users\MichaelPerkins\OneDrive - Nomi Health, Inc\Desktop\Projects\financial_dashboard_v3\.history\scripts\detect_environment_20230317131354.py", "Python", 8, 0, 2, 2, 12
"c:\Users\MichaelPerkins\OneDrive - Nomi Health, Inc\Desktop\Projects\financial_dashboard_v3\.history\scripts\detect_environment_20230317131358.py", "Python", 8, 0, 2, 2, 12
"c:\Users\MichaelPerkins\OneDrive - Nomi Health, Inc\Desktop\Projects\financial_dashboard_v3\.history\scripts\detect_environment_20230317131402.py", "Python", 8, 0, 2, 2, 12
"c:\Users\MichaelPerkins\OneDrive - Nomi Health, Inc\Desktop\Projects\financial_dashboard_v3\.history\scripts\format_cash_view_20230320131731.py", "Python", 55, 0, 24, 19, 98
"c:\Users\MichaelPerkins\OneDrive - Nomi Health, Inc\Desktop\Projects\financial_dashboard_v3\.history\scripts\format_cash_view_20230320131819.py", "Python", 14, 0, 4, 5, 23
"c:\Users\MichaelPerkins\OneDrive - Nomi Health, Inc\Desktop\Projects\financial_dashboard_v3\.history\scripts\get_actuals_date_20230317133832.py", "Python", 9, 0, 5, 3, 17
"c:\Users\MichaelPerkins\OneDrive - Nomi Health, Inc\Desktop\Projects\financial_dashboard_v3\.history\scripts\get_actuals_date_20230320101653.py", "Python", 5, 0, 1, 2, 8
"c:\Users\MichaelPerkins\OneDrive - Nomi Health, Inc\Desktop\Projects\financial_dashboard_v3\.history\scripts\get_actuals_date_20230320101701.py", "Python", 5, 0, 1, 2, 8
"c:\Users\MichaelPerkins\OneDrive - Nomi Health, Inc\Desktop\Projects\financial_dashboard_v3\.history\scripts\get_actuals_date_20230320101802.py", "Python", 5, 0, 1, 2, 8
"c:\Users\MichaelPerkins\OneDrive - Nomi Health, Inc\Desktop\Projects\financial_dashboard_v3\.history\scripts\get_actuals_date_20230320102238.py", "Python", 5, 0, 3, 2, 10
"c:\Users\MichaelPerkins\OneDrive - Nomi Health, Inc\Desktop\Projects\financial_dashboard_v3\.history\scripts\get_actuals_date_20230320102520.py", "Python", 7, 0, 3, 2, 12
"c:\Users\MichaelPerkins\OneDrive - Nomi Health, Inc\Desktop\Projects\financial_dashboard_v3\.history\scripts\get_actuals_date_20230320102610.py", "Python", 7, 0, 3, 2, 12
"c:\Users\MichaelPerkins\OneDrive - Nomi Health, Inc\Desktop\Projects\financial_dashboard_v3\.history\scripts\get_constants_20230317145405.py", "Python", 17, 0, 5, 7, 29
"c:\Users\MichaelPerkins\OneDrive - Nomi Health, Inc\Desktop\Projects\financial_dashboard_v3\.history\scripts\get_constants_20230320093050.py", "Python", 37, 0, 5, 8, 50
"c:\Users\MichaelPerkins\OneDrive - Nomi Health, Inc\Desktop\Projects\financial_dashboard_v3\.history\scripts\get_constants_20230320093107.py", "Python", 37, 0, 5, 8, 50
"c:\Users\MichaelPerkins\OneDrive - Nomi Health, Inc\Desktop\Projects\financial_dashboard_v3\.history\scripts\get_constants_20230320093304.py", "Python", 37, 0, 5, 7, 49
"c:\Users\MichaelPerkins\OneDrive - Nomi Health, Inc\Desktop\Projects\financial_dashboard_v3\.history\scripts\get_constants_20230320093330.py", "Python", 37, 0, 5, 7, 49
"c:\Users\MichaelPerkins\OneDrive - Nomi Health, Inc\Desktop\Projects\financial_dashboard_v3\.history\scripts\get_data_20230317131617.py", "Python", 8, 0, 4, 1, 13
"c:\Users\MichaelPerkins\OneDrive - Nomi Health, Inc\Desktop\Projects\financial_dashboard_v3\.history\scripts\get_data_20230317131652.py", "Python", 8, 0, 5, 2, 15
"c:\Users\MichaelPerkins\OneDrive - Nomi Health, Inc\Desktop\Projects\financial_dashboard_v3\.history\scripts\get_data_20230317132044.py", "Python", 9, 0, 5, 3, 17
"c:\Users\MichaelPerkins\OneDrive - Nomi Health, Inc\Desktop\Projects\financial_dashboard_v3\.history\scripts\get_data_20230317132217.py", "Python", 9, 0, 5, 3, 17
"c:\Users\MichaelPerkins\OneDrive - Nomi Health, Inc\Desktop\Projects\financial_dashboard_v3\.history\scripts\get_data_20230317132222.py", "Python", 9, 0, 5, 3, 17
"c:\Users\MichaelPerkins\OneDrive - Nomi Health, Inc\Desktop\Projects\financial_dashboard_v3\.history\scripts\get_data_20230317133833.py", "Python", 9, 0, 5, 3, 17
"c:\Users\MichaelPerkins\OneDrive - Nomi Health, Inc\Desktop\Projects\financial_dashboard_v3\.history\scripts\get_data_from_domo_20230317130604.py", "Python", 8, 0, 4, 4, 16
"c:\Users\MichaelPerkins\OneDrive - Nomi Health, Inc\Desktop\Projects\financial_dashboard_v3\.history\scripts\get_data_from_domo_20230317131252.py", "Python", 3, 0, 2, 0, 5
"c:\Users\MichaelPerkins\OneDrive - Nomi Health, Inc\Desktop\Projects\financial_dashboard_v3\.history\scripts\get_data_from_domo_20230317131413.py", "Python", 3, 0, 4, 0, 7
"c:\Users\MichaelPerkins\OneDrive - Nomi Health, Inc\Desktop\Projects\financial_dashboard_v3\.history\scripts\get_data_from_domo_20230317133956.py", "Python", 3, 0, 4, 0, 7
"c:\Users\MichaelPerkins\OneDrive - Nomi Health, Inc\Desktop\Projects\financial_dashboard_v3\.history\scripts\get_data_from_either_20230317131517.py", "Python", 8, 0, 7, 1, 16
"c:\Users\MichaelPerkins\OneDrive - Nomi Health, Inc\Desktop\Projects\financial_dashboard_v3\.history\scripts\get_data_from_either_20230317131618.py", "Python", 8, 0, 4, 1, 13
"c:\Users\MichaelPerkins\OneDrive - Nomi Health, Inc\Desktop\Projects\financial_dashboard_v3\.history\scripts\get_data_from_either_20230317131756.py", "Python", 8, 0, 4, 1, 13
"c:\Users\MichaelPerkins\OneDrive - Nomi Health, Inc\Desktop\Projects\financial_dashboard_v3\.history\scripts\get_data_from_either_20230317132110.py", "Python", 10, 0, 4, 2, 16
"c:\Users\MichaelPerkins\OneDrive - Nomi Health, Inc\Desktop\Projects\financial_dashboard_v3\.history\scripts\get_data_from_either_20230317132114.py", "Python", 11, 0, 4, 2, 17
"c:\Users\MichaelPerkins\OneDrive - Nomi Health, Inc\Desktop\Projects\financial_dashboard_v3\.history\scripts\get_data_from_either_20230317132207.py", "Python", 11, 0, 4, 2, 17
"c:\Users\MichaelPerkins\OneDrive - Nomi Health, Inc\Desktop\Projects\financial_dashboard_v3\.history\scripts\get_data_from_either_20230317132257.py", "Python", 11, 0, 4, 2, 17
"c:\Users\MichaelPerkins\OneDrive - Nomi Health, Inc\Desktop\Projects\financial_dashboard_v3\.history\scripts\get_data_from_either_20230317132451.py", "Python", 10, 0, 4, 2, 16
"c:\Users\MichaelPerkins\OneDrive - Nomi Health, Inc\Desktop\Projects\financial_dashboard_v3\.history\scripts\get_data_from_local_20230317131412.py", "Python", 3, 0, 4, 0, 7
"c:\Users\MichaelPerkins\OneDrive - Nomi Health, Inc\Desktop\Projects\financial_dashboard_v3\.history\scripts\get_data_from_local_20230317131448.py", "Python", 4, 0, 4, 1, 9
"c:\Users\MichaelPerkins\OneDrive - Nomi Health, Inc\Desktop\Projects\financial_dashboard_v3\.history\scripts\get_data_from_local_20230317131451.py", "Python", 4, 0, 4, 0, 8
"c:\Users\MichaelPerkins\OneDrive - Nomi Health, Inc\Desktop\Projects\financial_dashboard_v3\.history\scripts\get_data_from_local_20230317132054.py", "Python", 5, 0, 4, 1, 10
"c:\Users\MichaelPerkins\OneDrive - Nomi Health, Inc\Desktop\Projects\financial_dashboard_v3\.history\scripts\get_data_from_local_20230317132508.py", "Python", 6, 0, 4, 1, 11
"c:\Users\MichaelPerkins\OneDrive - Nomi Health, Inc\Desktop\Projects\financial_dashboard_v3\.history\scripts\get_data_from_local_20230317132515.py", "Python", 6, 0, 4, 1, 11
"c:\Users\MichaelPerkins\OneDrive - Nomi Health, Inc\Desktop\Projects\financial_dashboard_v3\.history\scripts\get_data_from_local_20230317132520.py", "Python", 6, 0, 4, 3, 13
"c:\Users\MichaelPerkins\OneDrive - Nomi Health, Inc\Desktop\Projects\financial_dashboard_v3\.history\scripts\get_data_from_local_20230317132523.py", "Python", 6, 0, 4, 1, 11
"c:\Users\MichaelPerkins\OneDrive - Nomi Health, Inc\Desktop\Projects\financial_dashboard_v3\.history\scripts\get_date_from_String_20230317133832.py", "Python", 9, 0, 5, 3, 17
"c:\Users\MichaelPerkins\OneDrive - Nomi Health, Inc\Desktop\Projects\financial_dashboard_v3\.history\scripts\get_date_from_String_20230320101641.py", "Python", 10, 0, 6, 4, 20
"c:\Users\MichaelPerkins\OneDrive - Nomi Health, Inc\Desktop\Projects\financial_dashboard_v3\.history\scripts\get_date_from_String_20230320101858.py", "Python", 10, 0, 6, 4, 20
"c:\Users\MichaelPerkins\OneDrive - Nomi Health, Inc\Desktop\Projects\financial_dashboard_v3\.history\scripts\get_date_from_String_20230320101935.py", "Python", 10, 0, 6, 4, 20
"c:\Users\MichaelPerkins\OneDrive - Nomi Health, Inc\Desktop\Projects\financial_dashboard_v3\.history\scripts\get_date_from_String_20230320102016.py", "Python", 10, 0, 6, 4, 20
"c:\Users\MichaelPerkins\OneDrive - Nomi Health, Inc\Desktop\Projects\financial_dashboard_v3\.history\scripts\join_name_map_to_actuals_20230320131731.py", "Python", 55, 0, 24, 19, 98
"c:\Users\MichaelPerkins\OneDrive - Nomi Health, Inc\Desktop\Projects\financial_dashboard_v3\.history\scripts\join_name_map_to_actuals_20230320131904.py", "Python", 26, 0, 15, 16, 57
"c:\Users\MichaelPerkins\OneDrive - Nomi Health, Inc\Desktop\Projects\financial_dashboard_v3\.history\scripts\main_20230317121256.py", "Python", 4, 0, 3, 2, 9
"c:\Users\MichaelPerkins\OneDrive - Nomi Health, Inc\Desktop\Projects\financial_dashboard_v3\.history\scripts\main_20230317124633.py", "Python", 8, 0, 4, 3, 15
"c:\Users\MichaelPerkins\OneDrive - Nomi Health, Inc\Desktop\Projects\financial_dashboard_v3\.history\scripts\main_20230317124730.py", "Python", 8, 0, 4, 3, 15
"c:\Users\MichaelPerkins\OneDrive - Nomi Health, Inc\Desktop\Projects\financial_dashboard_v3\.history\scripts\main_20230317124733.py", "Python", 8, 0, 4, 3, 15
"c:\Users\MichaelPerkins\OneDrive - Nomi Health, Inc\Desktop\Projects\financial_dashboard_v3\.history\scripts\main_20230317124808.py", "Python", 9, 0, 4, 4, 17
"c:\Users\MichaelPerkins\OneDrive - Nomi Health, Inc\Desktop\Projects\financial_dashboard_v3\.history\scripts\main_20230317124811.py", "Python", 9, 0, 4, 4, 17
"c:\Users\MichaelPerkins\OneDrive - Nomi Health, Inc\Desktop\Projects\financial_dashboard_v3\.history\scripts\main_20230317130636.py", "Python", 10, 0, 4, 5, 19
"c:\Users\MichaelPerkins\OneDrive - Nomi Health, Inc\Desktop\Projects\financial_dashboard_v3\.history\scripts\main_20230317130650.py", "Python", 10, 0, 4, 5, 19
"c:\Users\MichaelPerkins\OneDrive - Nomi Health, Inc\Desktop\Projects\financial_dashboard_v3\.history\scripts\main_20230317130655.py", "Python", 10, 0, 4, 5, 19
"c:\Users\MichaelPerkins\OneDrive - Nomi Health, Inc\Desktop\Projects\financial_dashboard_v3\.history\scripts\main_20230317130934.py", "Python", 8, 0, 4, 5, 17
"c:\Users\MichaelPerkins\OneDrive - Nomi Health, Inc\Desktop\Projects\financial_dashboard_v3\.history\scripts\main_20230317131006.py", "Python", 7, 0, 5, 5, 17
"c:\Users\MichaelPerkins\OneDrive - Nomi Health, Inc\Desktop\Projects\financial_dashboard_v3\.history\scripts\main_20230317131014.py", "Python", 8, 0, 4, 5, 17
"c:\Users\MichaelPerkins\OneDrive - Nomi Health, Inc\Desktop\Projects\financial_dashboard_v3\.history\scripts\main_20230317132013.py", "Python", 15, 0, 4, 6, 25
"c:\Users\MichaelPerkins\OneDrive - Nomi Health, Inc\Desktop\Projects\financial_dashboard_v3\.history\scripts\main_20230317132020.py", "Python", 15, 0, 4, 6, 25
"c:\Users\MichaelPerkins\OneDrive - Nomi Health, Inc\Desktop\Projects\financial_dashboard_v3\.history\scripts\main_20230317132227.py", "Python", 15, 0, 4, 6, 25
"c:\Users\MichaelPerkins\OneDrive - Nomi Health, Inc\Desktop\Projects\financial_dashboard_v3\.history\scripts\main_20230317132416.py", "Python", 15, 0, 4, 6, 25
"c:\Users\MichaelPerkins\OneDrive - Nomi Health, Inc\Desktop\Projects\financial_dashboard_v3\.history\scripts\main_20230317133830.py", "Python", 17, 0, 4, 7, 28
"c:\Users\MichaelPerkins\OneDrive - Nomi Health, Inc\Desktop\Projects\financial_dashboard_v3\.history\scripts\main_20230317140026.py", "Python", 17, 0, 4, 7, 28
"c:\Users\MichaelPerkins\OneDrive - Nomi Health, Inc\Desktop\Projects\financial_dashboard_v3\.history\scripts\main_20230317140335.py", "Python", 17, 0, 4, 7, 28
"c:\Users\MichaelPerkins\OneDrive - Nomi Health, Inc\Desktop\Projects\financial_dashboard_v3\.history\scripts\main_20230317140346.py", "Python", 17, 0, 4, 7, 28
"c:\Users\MichaelPerkins\OneDrive - Nomi Health, Inc\Desktop\Projects\financial_dashboard_v3\.history\scripts\main_20230317145358.py", "Python", 17, 0, 4, 7, 28
"c:\Users\MichaelPerkins\OneDrive - Nomi Health, Inc\Desktop\Projects\financial_dashboard_v3\.history\scripts\main_20230317145406.py", "Python", 17, 0, 5, 7, 29
"c:\Users\MichaelPerkins\OneDrive - Nomi Health, Inc\Desktop\Projects\financial_dashboard_v3\.history\scripts\main_20230320092740.py", "Python", 17, 0, 4, 6, 27
"c:\Users\MichaelPerkins\OneDrive - Nomi Health, Inc\Desktop\Projects\financial_dashboard_v3\.history\scripts\main_20230320092743.py", "Python", 17, 0, 4, 4, 25
"c:\Users\MichaelPerkins\OneDrive - Nomi Health, Inc\Desktop\Projects\financial_dashboard_v3\.history\scripts\main_20230320093400.py", "Python", 37, 0, 5, 7, 49
"c:\Users\MichaelPerkins\OneDrive - Nomi Health, Inc\Desktop\Projects\financial_dashboard_v3\.history\scripts\main_20230320100517.py", "Python", 59, 0, 8, 8, 75
"c:\Users\MichaelPerkins\OneDrive - Nomi Health, Inc\Desktop\Projects\financial_dashboard_v3\.history\scripts\main_20230320100630.py", "Python", 69, 0, 8, 8, 85
"c:\Users\MichaelPerkins\OneDrive - Nomi Health, Inc\Desktop\Projects\financial_dashboard_v3\.history\scripts\main_20230320101745.py", "Python", 72, 0, 9, 11, 92
"c:\Users\MichaelPerkins\OneDrive - Nomi Health, Inc\Desktop\Projects\financial_dashboard_v3\.history\scripts\main_20230320102536.py", "Python", 71, 0, 9, 12, 92
"c:\Users\MichaelPerkins\OneDrive - Nomi Health, Inc\Desktop\Projects\financial_dashboard_v3\.history\scripts\main_20230320102543.py", "Python", 71, 0, 9, 12, 92
"c:\Users\MichaelPerkins\OneDrive - Nomi Health, Inc\Desktop\Projects\financial_dashboard_v3\.history\scripts\main_20230320103954.py", "Python", 25, 0, 6, 9, 40
"c:\Users\MichaelPerkins\OneDrive - Nomi Health, Inc\Desktop\Projects\financial_dashboard_v3\.history\scripts\main_20230320104733.py", "Python", 29, 0, 6, 9, 44
"c:\Users\MichaelPerkins\OneDrive - Nomi Health, Inc\Desktop\Projects\financial_dashboard_v3\.history\scripts\main_20230320104752.py", "Python", 29, 0, 6, 9, 44
"c:\Users\MichaelPerkins\OneDrive - Nomi Health, Inc\Desktop\Projects\financial_dashboard_v3\.history\scripts\main_20230320104824.py", "Python", 29, 0, 6, 9, 44
"c:\Users\MichaelPerkins\OneDrive - Nomi Health, Inc\Desktop\Projects\financial_dashboard_v3\.history\scripts\main_20230320110327.py", "Python", 31, 0, 6, 10, 47
"c:\Users\MichaelPerkins\OneDrive - Nomi Health, Inc\Desktop\Projects\financial_dashboard_v3\.history\scripts\main_20230320110620.py", "Python", 40, 0, 9, 11, 60
"c:\Users\MichaelPerkins\OneDrive - Nomi Health, Inc\Desktop\Projects\financial_dashboard_v3\.history\scripts\main_20230320110942.py", "Python", 40, 0, 9, 11, 60
"c:\Users\MichaelPerkins\OneDrive - Nomi Health, Inc\Desktop\Projects\financial_dashboard_v3\.history\scripts\main_20230320114508.py", "Python", 40, 0, 8, 11, 59
"c:\Users\MichaelPerkins\OneDrive - Nomi Health, Inc\Desktop\Projects\financial_dashboard_v3\.history\scripts\print_columns_20230317131450.py", "Python", 4, 0, 4, 0, 8
"c:\Users\MichaelPerkins\OneDrive - Nomi Health, Inc\Desktop\Projects\financial_dashboard_v3\.history\scripts\print_columns_20230317131518.py", "Python", 8, 0, 7, 1, 16
"c:\Users\MichaelPerkins\OneDrive - Nomi Health, Inc\Desktop\Projects\financial_dashboard_v3\.history\scripts\print_columns_20230317135429.py", "Python", 9, 0, 8, 2, 19
"c:\Users\MichaelPerkins\OneDrive - Nomi Health, Inc\Desktop\Projects\financial_dashboard_v3\.history\scripts\print_columns_20230317135435.py", "Python", 9, 0, 8, 2, 19
"c:\Users\MichaelPerkins\OneDrive - Nomi Health, Inc\Desktop\Projects\financial_dashboard_v3\.history\scripts\print_columns_20230317135438.py", "Python", 8, 0, 8, 2, 18
"c:\Users\MichaelPerkins\OneDrive - Nomi Health, Inc\Desktop\Projects\financial_dashboard_v3\.history\scripts\print_columns_20230317135611.py", "Python", 8, 0, 8, 2, 18
"c:\Users\MichaelPerkins\OneDrive - Nomi Health, Inc\Desktop\Projects\financial_dashboard_v3\.history\scripts\print_columns_20230320102443.py", "Python", 7, 0, 7, 2, 16
"c:\Users\MichaelPerkins\OneDrive - Nomi Health, Inc\Desktop\Projects\financial_dashboard_v3\.history\scripts\remove_string_from_column_20230320131154.py", "Python", 53, 0, 23, 13, 89
"c:\Users\MichaelPerkins\OneDrive - Nomi Health, Inc\Desktop\Projects\financial_dashboard_v3\.history\scripts\remove_string_from_column_20230320131708.py", "Python", 11, 0, 4, 5, 20
"c:\Users\MichaelPerkins\OneDrive - Nomi Health, Inc\Desktop\Projects\financial_dashboard_v3\.history\scripts\remove_string_from_column_20230320134952.py", "Python", 11, 0, 4, 5, 20
"c:\Users\MichaelPerkins\OneDrive - Nomi Health, Inc\Desktop\Projects\financial_dashboard_v3\.history\scripts\remove_string_from_column_20230320135200.py", "Python", 11, 0, 4, 7, 22
"c:\Users\MichaelPerkins\OneDrive - Nomi Health, Inc\Desktop\Projects\financial_dashboard_v3\.history\scripts\remove_string_from_column_20230320135218.py", "Python", 11, 0, 4, 7, 22
"c:\Users\MichaelPerkins\OneDrive - Nomi Health, Inc\Desktop\Projects\financial_dashboard_v3\.history\scripts\script_1_20230317120946.py", "Python", 0, 0, 0, 1, 1
"c:\Users\MichaelPerkins\OneDrive - Nomi Health, Inc\Desktop\Projects\financial_dashboard_v3\.history\scripts\script_1_20230317121009.py", "Python", 4, 0, 2, 3, 9
"c:\Users\MichaelPerkins\OneDrive - Nomi Health, Inc\Desktop\Projects\financial_dashboard_v3\.history\scripts\script_1_20230317121010.py", "Python", 4, 0, 2, 2, 8
"c:\Users\MichaelPerkins\OneDrive - Nomi Health, Inc\Desktop\Projects\financial_dashboard_v3\.history\scripts\script_1_20230317121020.py", "Python", 4, 0, 2, 2, 8
"c:\Users\MichaelPerkins\OneDrive - Nomi Health, Inc\Desktop\Projects\financial_dashboard_v3\.history\scripts\script_1_20230317121249.py", "Python", 4, 0, 4, 2, 10
"c:\Users\MichaelPerkins\OneDrive - Nomi Health, Inc\Desktop\Projects\financial_dashboard_v3\.history\scripts\script_2_20230317121019.py", "Python", 4, 0, 2, 2, 8
"c:\Users\MichaelPerkins\OneDrive - Nomi Health, Inc\Desktop\Projects\financial_dashboard_v3\.history\scripts\script_2_20230317121128.py", "Python", 4, 0, 1, 2, 7
"c:\Users\MichaelPerkins\OneDrive - Nomi Health, Inc\Desktop\Projects\financial_dashboard_v3\.history\scripts\script_2_20230317121257.py", "Python", 4, 0, 3, 2, 9
"c:\Users\MichaelPerkins\OneDrive - Nomi Health, Inc\Desktop\Projects\financial_dashboard_v3\.history\scripts\setup_data_validation_20230317133832.py", "Python", 9, 0, 5, 3, 17
"c:\Users\MichaelPerkins\OneDrive - Nomi Health, Inc\Desktop\Projects\financial_dashboard_v3\.history\scripts\setup_data_validation_20230320110224.py", "Python", 6, 0, 19, 8, 33
"c:\Users\MichaelPerkins\OneDrive - Nomi Health, Inc\Desktop\Projects\financial_dashboard_v3\.history\scripts\setup_data_validation_20230320110937.py", "Python", 7, 0, 20, 9, 36
"c:\Users\MichaelPerkins\OneDrive - Nomi Health, Inc\Desktop\Projects\financial_dashboard_v3\.history\scripts\setup_data_validation_20230320111819.py", "Python", 7, 0, 22, 9, 38
"c:\Users\MichaelPerkins\OneDrive - Nomi Health, Inc\Desktop\Projects\financial_dashboard_v3\.history\scripts\setup_data_validation_20230320112948.py", "Python", 19, 0, 18, 9, 46
"c:\Users\MichaelPerkins\OneDrive - Nomi Health, Inc\Desktop\Projects\financial_dashboard_v3\.history\scripts\setup_data_validation_20230320112956.py", "Python", 23, 0, 14, 9, 46
"c:\Users\MichaelPerkins\OneDrive - Nomi Health, Inc\Desktop\Projects\financial_dashboard_v3\.history\scripts\setup_data_validation_20230320113100.py", "Python", 23, 0, 14, 9, 46
"c:\Users\MichaelPerkins\OneDrive - Nomi Health, Inc\Desktop\Projects\financial_dashboard_v3\.history\scripts\setup_data_validation_20230320114353.py", "Python", 26, 0, 12, 9, 47
"c:\Users\MichaelPerkins\OneDrive - Nomi Health, Inc\Desktop\Projects\financial_dashboard_v3\.history\scripts\setup_data_validation_20230320114523.py", "Python", 27, 0, 12, 9, 48
"c:\Users\MichaelPerkins\OneDrive - Nomi Health, Inc\Desktop\Projects\financial_dashboard_v3\.history\scripts\setup_data_validation_actuals_20230320113245.py", "Python", 9, 0, 5, 3, 17
"c:\Users\MichaelPerkins\OneDrive - Nomi Health, Inc\Desktop\Projects\financial_dashboard_v3\.history\scripts\setup_data_validation_actuals_20230320114400.py", "Python", 48, 0, 25, 16, 89
"c:\Users\MichaelPerkins\OneDrive - Nomi Health, Inc\Desktop\Projects\financial_dashboard_v3\.history\scripts\setup_data_validation_actuals_20230320114552.py", "Python", 49, 0, 25, 16, 90
"c:\Users\MichaelPerkins\OneDrive - Nomi Health, Inc\Desktop\Projects\financial_dashboard_v3\.history\scripts\setup_data_validation_actuals_20230320115214.py", "Python", 48, 0, 25, 16, 89
"c:\Users\MichaelPerkins\OneDrive - Nomi Health, Inc\Desktop\Projects\financial_dashboard_v3\.history\scripts\setup_data_validation_actuals_20230320115410.py", "Python", 45, 0, 25, 13, 83
"c:\Users\MichaelPerkins\OneDrive - Nomi Health, Inc\Desktop\Projects\financial_dashboard_v3\.history\scripts\setup_data_validation_actuals_20230320115419.py", "Python", 45, 0, 25, 13, 83
"c:\Users\MichaelPerkins\OneDrive - Nomi Health, Inc\Desktop\Projects\financial_dashboard_v3\.history\scripts\setup_data_validation_actuals_20230320115427.py", "Python", 45, 0, 25, 14, 84
"c:\Users\MichaelPerkins\OneDrive - Nomi Health, Inc\Desktop\Projects\financial_dashboard_v3\.history\scripts\setup_data_validation_actuals_20230320115451.py", "Python", 44, 0, 24, 12, 80
"c:\Users\MichaelPerkins\OneDrive - Nomi Health, Inc\Desktop\Projects\financial_dashboard_v3\.history\scripts\setup_data_validation_actuals_20230320115950.py", "Python", 33, 0, 16, 10, 59
"c:\Users\MichaelPerkins\OneDrive - Nomi Health, Inc\Desktop\Projects\financial_dashboard_v3\.history\scripts\setup_data_validation_actuals_20230320120015.py", "Python", 31, 0, 15, 10, 56
"c:\Users\MichaelPerkins\OneDrive - Nomi Health, Inc\Desktop\Projects\financial_dashboard_v3\.history\scripts\setup_data_validation_actuals_20230320120555.py", "Python", 31, 0, 15, 10, 56
"c:\Users\MichaelPerkins\OneDrive - Nomi Health, Inc\Desktop\Projects\financial_dashboard_v3\.history\scripts\setup_data_validation_ftc_20230320111820.py", "Python", 9, 0, 6, 4, 19
"c:\Users\MichaelPerkins\OneDrive - Nomi Health, Inc\Desktop\Projects\financial_dashboard_v3\.history\scripts\setup_data_validation_ftc_20230320112744.py", "Python", 9, 0, 5, 3, 17
"c:\Users\MichaelPerkins\OneDrive - Nomi Health, Inc\Desktop\Projects\financial_dashboard_v3\.history\scripts\setup_data_validation_ftc_20230320113058.py", "Python", 9, 0, 5, 3, 17
"c:\Users\MichaelPerkins\OneDrive - Nomi Health, Inc\Desktop\Projects\financial_dashboard_v3\.history\scripts\setup_data_validation_ftc_20230320113142.py", "Python", 9, 0, 5, 3, 17
"c:\Users\MichaelPerkins\OneDrive - Nomi Health, Inc\Desktop\Projects\financial_dashboard_v3\.history\scripts\setup_data_validation_fte_20230317133832.py", "Python", 9, 0, 5, 3, 17
"c:\Users\MichaelPerkins\OneDrive - Nomi Health, Inc\Desktop\Projects\financial_dashboard_v3\.history\scripts\setup_data_validation_fte_20230320110328.py", "Python", 8, 0, 4, 3, 15
"c:\Users\MichaelPerkins\OneDrive - Nomi Health, Inc\Desktop\Projects\financial_dashboard_v3\.history\scripts\setup_data_validation_fte_20230320111056.py", "Python", 9, 0, 4, 4, 17
"c:\Users\MichaelPerkins\OneDrive - Nomi Health, Inc\Desktop\Projects\financial_dashboard_v3\.history\scripts\setup_data_validation_fte_20230320111821.py", "Python", 9, 0, 6, 4, 19
"c:\Users\MichaelPerkins\OneDrive - Nomi Health, Inc\Desktop\Projects\financial_dashboard_v3\.history\scripts\setup_data_validation_fte_20230320113001.py", "Python", 9, 0, 6, 4, 19
"c:\Users\MichaelPerkins\OneDrive - Nomi Health, Inc\Desktop\Projects\financial_dashboard_v3\.history\scripts\setup_data_validation_fte_20230320113058.py", "Python", 9, 0, 6, 4, 19
"c:\Users\MichaelPerkins\OneDrive - Nomi Health, Inc\Desktop\Projects\financial_dashboard_v3\.history\scripts\setup_data_validation_fte_20230320113158.py", "Python", 9, 0, 6, 4, 19
"c:\Users\MichaelPerkins\OneDrive - Nomi Health, Inc\Desktop\Projects\financial_dashboard_v3\.history\scripts\setup_data_validation_orm_20230320111820.py", "Python", 9, 0, 6, 4, 19
"c:\Users\MichaelPerkins\OneDrive - Nomi Health, Inc\Desktop\Projects\financial_dashboard_v3\.history\scripts\setup_data_validation_orm_20230320113001.py", "Python", 9, 0, 5, 3, 17
"c:\Users\MichaelPerkins\OneDrive - Nomi Health, Inc\Desktop\Projects\financial_dashboard_v3\.history\scripts\setup_data_validation_orm_20230320113057.py", "Python", 9, 0, 5, 3, 17
"c:\Users\MichaelPerkins\OneDrive - Nomi Health, Inc\Desktop\Projects\financial_dashboard_v3\.history\scripts\setup_data_validation_orm_20230320113215.py", "Python", 10, 0, 5, 3, 18
"c:\Users\MichaelPerkins\OneDrive - Nomi Health, Inc\Desktop\Projects\financial_dashboard_v3\.history\scripts\setup_data_validation_orm_20230320113219.py", "Python", 9, 0, 5, 3, 17
"c:\Users\MichaelPerkins\OneDrive - Nomi Health, Inc\Desktop\Projects\financial_dashboard_v3\.history\scripts\setup_data_validation_pro_serv_20230320112743.py", "Python", 9, 0, 5, 3, 17
"c:\Users\MichaelPerkins\OneDrive - Nomi Health, Inc\Desktop\Projects\financial_dashboard_v3\.history\scripts\setup_data_validation_pro_serv_20230320112914.py", "Python", 9, 0, 5, 3, 17
"c:\Users\MichaelPerkins\OneDrive - Nomi Health, Inc\Desktop\Projects\financial_dashboard_v3\.history\scripts\setup_data_validation_pro_serv_20230320113056.py", "Python", 9, 0, 5, 3, 17
"c:\Users\MichaelPerkins\OneDrive - Nomi Health, Inc\Desktop\Projects\financial_dashboard_v3\.history\scripts\setup_data_validation_pro_serv_20230320113234.py", "Python", 9, 0, 5, 3, 17
"c:\Users\MichaelPerkins\OneDrive - Nomi Health, Inc\Desktop\Projects\financial_dashboard_v3\.history\scripts\setup_data_validation_software_20230320112913.py", "Python", 9, 0, 5, 3, 17
"c:\Users\MichaelPerkins\OneDrive - Nomi Health, Inc\Desktop\Projects\financial_dashboard_v3\.history\scripts\setup_data_validation_software_20230320112939.py", "Python", 9, 0, 5, 3, 17
"c:\Users\MichaelPerkins\OneDrive - Nomi Health, Inc\Desktop\Projects\financial_dashboard_v3\.history\scripts\setup_data_validation_software_20230320113055.py", "Python", 9, 0, 5, 3, 17
"c:\Users\MichaelPerkins\OneDrive - Nomi Health, Inc\Desktop\Projects\financial_dashboard_v3\.history\scripts\setup_data_validation_software_20230320113246.py", "Python", 9, 0, 5, 3, 17
"c:\Users\MichaelPerkins\OneDrive - Nomi Health, Inc\Desktop\Projects\financial_dashboard_v3\.history\scripts\write_data_20230317132221.py", "Python", 9, 0, 5, 3, 17
"c:\Users\MichaelPerkins\OneDrive - Nomi Health, Inc\Desktop\Projects\financial_dashboard_v3\.history\scripts\write_data_20230317133720.py", "Python", 5, 0, 2, 1, 8
"c:\Users\MichaelPerkins\OneDrive - Nomi Health, Inc\Desktop\Projects\financial_dashboard_v3\.history\scripts\write_data_20230317133739.py", "Python", 5, 0, 2, 1, 8
"c:\Users\MichaelPerkins\OneDrive - Nomi Health, Inc\Desktop\Projects\financial_dashboard_v3\.history\scripts\write_data_20230317133747.py", "Python", 5, 0, 2, 1, 8
"c:\Users\MichaelPerkins\OneDrive - Nomi Health, Inc\Desktop\Projects\financial_dashboard_v3\.history\scripts\write_data_20230317133753.py", "Python", 5, 0, 2, 0, 7
"c:\Users\MichaelPerkins\OneDrive - Nomi Health, Inc\Desktop\Projects\financial_dashboard_v3\.history\scripts\write_data_20230317133759.py", "Python", 5, 0, 2, 0, 7
"c:\Users\MichaelPerkins\OneDrive - Nomi Health, Inc\Desktop\Projects\financial_dashboard_v3\.history\scripts\write_data_20230320111111.py", "Python", 5, 0, 2, 0, 7
"c:\Users\MichaelPerkins\OneDrive - Nomi Health, Inc\Desktop\Projects\financial_dashboard_v3\compile_scripts.py", "Python", 61, 0, 20, 10, 91
"c:\Users\MichaelPerkins\OneDrive - Nomi Health, Inc\Desktop\Projects\financial_dashboard_v3\compiled_scripts\archive\03172023\output_2023-03-17_13-01-27.py", "Python", 0, 0, 0, 3, 3
"c:\Users\MichaelPerkins\OneDrive - Nomi Health, Inc\Desktop\Projects\financial_dashboard_v3\compiled_scripts\archive\03172023\output_2023-03-17_13-01-45.py", "Python", 11, 0, 0, 5, 16
"c:\Users\MichaelPerkins\OneDrive - Nomi Health, Inc\Desktop\Projects\financial_dashboard_v3\compiled_scripts\archive\03172023\output_2023-03-17_13-13-26.py", "Python", 11, 0, 0, 6, 17
"c:\Users\MichaelPerkins\OneDrive - Nomi Health, Inc\Desktop\Projects\financial_dashboard_v3\compiled_scripts\archive\03172023\output_2023-03-17_13-14-17.py", "Python", 14, 0, 2, 8, 24
"c:\Users\MichaelPerkins\OneDrive - Nomi Health, Inc\Desktop\Projects\financial_dashboard_v3\compiled_scripts\archive\03172023\output_2023-03-17_13-17-57.py", "Python", 29, 0, 11, 14, 54
"c:\Users\MichaelPerkins\OneDrive - Nomi Health, Inc\Desktop\Projects\financial_dashboard_v3\compiled_scripts\archive\03172023\output_2023-03-17_13-18-25.py", "Python", 42, 0, 14, 20, 76
"c:\Users\MichaelPerkins\OneDrive - Nomi Health, Inc\Desktop\Projects\financial_dashboard_v3\compiled_scripts\archive\03172023\output_2023-03-17_13-26-04.py", "Python", 49, 0, 14, 19, 82
"c:\Users\MichaelPerkins\OneDrive - Nomi Health, Inc\Desktop\Projects\financial_dashboard_v3\compiled_scripts\archive\03172023\output_2023-03-17_13-26-18.py", "Python", 56, 0, 20, 22, 98
"c:\Users\MichaelPerkins\OneDrive - Nomi Health, Inc\Desktop\Projects\financial_dashboard_v3\compiled_scripts\archive\03172023\output_2023-03-17_13-39-05.py", "Python", 62, 0, 20, 24, 106
"c:\Users\MichaelPerkins\OneDrive - Nomi Health, Inc\Desktop\Projects\financial_dashboard_v3\compiled_scripts\archive\03172023\output_2023-03-17_13-46-53.py", "Python", 63, 0, 20, 25, 108
"c:\Users\MichaelPerkins\OneDrive - Nomi Health, Inc\Desktop\Projects\financial_dashboard_v3\compiled_scripts\archive\03172023\output_2023-03-17_13-51-30.py", "Python", 64, 0, 20, 24, 108
"c:\Users\MichaelPerkins\OneDrive - Nomi Health, Inc\Desktop\Projects\financial_dashboard_v3\compiled_scripts\archive\03172023\output_2023-03-17_14-03-57.py", "Python", 64, 0, 21, 23, 108
"c:\Users\MichaelPerkins\OneDrive - Nomi Health, Inc\Desktop\Projects\financial_dashboard_v3\compiled_scripts\archive\03172023\output_2023-03-17_14-53-28.py", "Python", 65, 0, 21, 24, 110
"c:\Users\MichaelPerkins\OneDrive - Nomi Health, Inc\Desktop\Projects\financial_dashboard_v3\compiled_scripts\archive\03172023\output_2023-03-17_14-54-39.py", "Python", 64, 0, 21, 24, 109
"c:\Users\MichaelPerkins\OneDrive - Nomi Health, Inc\Desktop\Projects\financial_dashboard_v3\compiled_scripts\archive\03172023\output_2023-03-17_15-23-40.py", "Python", 64, 0, 21, 5, 90
"c:\Users\MichaelPerkins\OneDrive - Nomi Health, Inc\Desktop\Projects\financial_dashboard_v3\compiled_scripts\archive\03172023\output_2023-03-17_15-24-13.py", "Python", 64, 0, 21, 24, 109
"c:\Users\MichaelPerkins\OneDrive - Nomi Health, Inc\Desktop\Projects\financial_dashboard_v3\compiled_scripts\archive\03172023\output_2023-03-17_15-28-24.py", "Python", 64, 0, 21, 1, 86
"c:\Users\MichaelPerkins\OneDrive - Nomi Health, Inc\Desktop\Projects\financial_dashboard_v3\compiled_scripts\archive\03202023\output_2023-03-20_10-40-31.py", "Python", 84, 0, 26, 4, 114
"c:\Users\MichaelPerkins\OneDrive - Nomi Health, Inc\Desktop\Projects\financial_dashboard_v3\compiled_scripts\archive\03202023\output_2023-03-20_10-42-33.py", "Python", 131, 0, 29, 4, 164
"c:\Users\MichaelPerkins\OneDrive - Nomi Health, Inc\Desktop\Projects\financial_dashboard_v3\compiled_scripts\archive\03202023\output_2023-03-20_10-48-25.py", "Python", 144, 0, 36, 4, 184
"c:\Users\MichaelPerkins\OneDrive - Nomi Health, Inc\Desktop\Projects\financial_dashboard_v3\compiled_scripts\archive\03202023\output_2023-03-20_11-11-13.py", "Python", 164, 0, 40, 3, 207
"c:\Users\MichaelPerkins\OneDrive - Nomi Health, Inc\Desktop\Projects\financial_dashboard_v3\compiled_scripts\archive\03202023\output_2023-03-20_11-14-23.py", "Python", 164, 0, 40, 3, 207
"c:\Users\MichaelPerkins\OneDrive - Nomi Health, Inc\Desktop\Projects\financial_dashboard_v3\compiled_scripts\archive\03202023\output_2023-03-20_11-17-06.py", "Python", 164, 0, 40, 3, 207
"c:\Users\MichaelPerkins\OneDrive - Nomi Health, Inc\Desktop\Projects\financial_dashboard_v3\compiled_scripts\archive\03202023\output_2023-03-20_11-17-26.py", "Python", 164, 0, 40, 3, 207
"c:\Users\MichaelPerkins\OneDrive - Nomi Health, Inc\Desktop\Projects\financial_dashboard_v3\compiled_scripts\archive\03202023\output_2023-03-20_11-18-22.py", "Python", 178, 0, 64, 3, 245
"c:\Users\MichaelPerkins\OneDrive - Nomi Health, Inc\Desktop\Projects\financial_dashboard_v3\compiled_scripts\archive\03202023\output_2023-03-20_11-33-23.py", "Python", 235, 0, 68, 4, 307
"c:\Users\MichaelPerkins\OneDrive - Nomi Health, Inc\Desktop\Projects\financial_dashboard_v3\compiled_scripts\archive\03202023\output_2023-03-20_11-47-19.py", "Python", 312, 0, 89, 5, 406
"c:\Users\MichaelPerkins\OneDrive - Nomi Health, Inc\Desktop\Projects\financial_dashboard_v3\compiled_scripts\archive\03202023\output_2023-03-20_11-55-00.py", "Python", 307, 0, 88, 5, 400
"c:\Users\MichaelPerkins\OneDrive - Nomi Health, Inc\Desktop\Projects\financial_dashboard_v3\compiled_scripts\archive\03202023\output_2023-03-20_12-00-19.py", "Python", 294, 0, 79, 4, 377
"c:\Users\MichaelPerkins\OneDrive - Nomi Health, Inc\Desktop\Projects\financial_dashboard_v3\compiled_scripts\archive\03202023\output_2023-03-20_12-05-59.py", "Python", 294, 0, 79, 4, 377
"c:\Users\MichaelPerkins\OneDrive - Nomi Health, Inc\Desktop\Projects\financial_dashboard_v3\compiled_scripts\archive\output_2023-03-20_09-22-00.py", "Python", 64, 0, 21, 1, 86
"c:\Users\MichaelPerkins\OneDrive - Nomi Health, Inc\Desktop\Projects\financial_dashboard_v3\compiled_scripts\archive\output_2023-03-20_09-33-35.py", "Python", 64, 0, 21, 1, 86
"c:\Users\MichaelPerkins\OneDrive - Nomi Health, Inc\Desktop\Projects\financial_dashboard_v3\compiled_scripts\archive\output_2023-03-20_09-34-03.py", "Python", 84, 0, 21, 1, 106
"c:\Users\MichaelPerkins\OneDrive - Nomi Health, Inc\Desktop\Projects\financial_dashboard_v3\compiled_scripts\archive\output_2023-03-20_10-06-34.py", "Python", 116, 0, 24, 1, 141
"c:\Users\MichaelPerkins\OneDrive - Nomi Health, Inc\Desktop\Projects\financial_dashboard_v3\compiled_scripts\archive\output_2023-03-20_10-18-31.py", "Python", 118, 0, 25, 2, 145
"c:\Users\MichaelPerkins\OneDrive - Nomi Health, Inc\Desktop\Projects\financial_dashboard_v3\compiled_scripts\archive\output_2023-03-20_10-19-11.py", "Python", 118, 0, 25, 2, 145
"c:\Users\MichaelPerkins\OneDrive - Nomi Health, Inc\Desktop\Projects\financial_dashboard_v3\compiled_scripts\archive\output_2023-03-20_10-20-04.py", "Python", 127, 0, 29, 2, 158
"c:\Users\MichaelPerkins\OneDrive - Nomi Health, Inc\Desktop\Projects\financial_dashboard_v3\compiled_scripts\archive\output_2023-03-20_10-20-20.py", "Python", 128, 0, 29, 2, 159
"c:\Users\MichaelPerkins\OneDrive - Nomi Health, Inc\Desktop\Projects\financial_dashboard_v3\compiled_scripts\archive\output_2023-03-20_10-22-23.py", "Python", 128, 0, 29, 2, 159
"c:\Users\MichaelPerkins\OneDrive - Nomi Health, Inc\Desktop\Projects\financial_dashboard_v3\compiled_scripts\archive\output_2023-03-20_10-22-40.py", "Python", 132, 0, 30, 3, 165
"c:\Users\MichaelPerkins\OneDrive - Nomi Health, Inc\Desktop\Projects\financial_dashboard_v3\compiled_scripts\archive\output_2023-03-20_10-26-11.py", "Python", 131, 0, 29, 4, 164
"c:\Users\MichaelPerkins\OneDrive - Nomi Health, Inc\Desktop\Projects\financial_dashboard_v3\compiled_scripts\output_2023-03-20_12-07-53.py", "Python", 294, 0, 79, 4, 377
"c:\Users\MichaelPerkins\OneDrive - Nomi Health, Inc\Desktop\Projects\financial_dashboard_v3\compiled_scripts\output_2023-03-20_12-09-43.py", "Python", 294, 0, 79, 4, 377
"c:\Users\MichaelPerkins\OneDrive - Nomi Health, Inc\Desktop\Projects\financial_dashboard_v3\compiled_scripts\output_2023-03-20_12-17-27.py", "Python", 310, 0, 82, 4, 396
"c:\Users\MichaelPerkins\OneDrive - Nomi Health, Inc\Desktop\Projects\financial_dashboard_v3\compiled_scripts\output_2023-03-20_12-18-21.py", "Python", 361, 0, 105, 6, 472
"c:\Users\MichaelPerkins\OneDrive - Nomi Health, Inc\Desktop\Projects\financial_dashboard_v3\compiled_scripts\output_2023-03-20_12-28-05.py", "Python", 361, 0, 108, 6, 475
"c:\Users\MichaelPerkins\OneDrive - Nomi Health, Inc\Desktop\Projects\financial_dashboard_v3\compiled_scripts\output_2023-03-20_13-03-44.py", "Python", 376, 0, 113, 5, 494
"c:\Users\MichaelPerkins\OneDrive - Nomi Health, Inc\Desktop\Projects\financial_dashboard_v3\compiled_scripts\output_2023-03-20_13-11-58.py", "Python", 367, 0, 109, 5, 481
"c:\Users\MichaelPerkins\OneDrive - Nomi Health, Inc\Desktop\Projects\financial_dashboard_v3\compiled_scripts\output_2023-03-20_13-23-42.py", "Python", 456, 0, 138, 5, 599
"c:\Users\MichaelPerkins\OneDrive - Nomi Health, Inc\Desktop\Projects\financial_dashboard_v3\compiled_scripts\output_2023-03-20_13-25-28.py", "Python", 477, 0, 151, 6, 634
"c:\Users\MichaelPerkins\OneDrive - Nomi Health, Inc\Desktop\Projects\financial_dashboard_v3\compiled_scripts\output_2023-03-20_13-45-38.py", "Python", 477, 0, 153, 8, 638
"c:\Users\MichaelPerkins\OneDrive - Nomi Health, Inc\Desktop\Projects\financial_dashboard_v3\compiled_scripts\output_2023-03-20_13-49-56.py", "Python", 477, 0, 153, 8, 638
"c:\Users\MichaelPerkins\OneDrive - Nomi Health, Inc\Desktop\Projects\financial_dashboard_v3\compiled_scripts\output_2023-03-20_13-52-29.py", "Python", 477, 0, 153, 9, 639
"c:\Users\MichaelPerkins\OneDrive - Nomi Health, Inc\Desktop\Projects\financial_dashboard_v3\data\2023\Vendor Name Map.csv", "CSV", 0, 193, 0, 1, 194
"c:\Users\MichaelPerkins\OneDrive - Nomi Health, Inc\Desktop\Projects\financial_dashboard_v3\data\2023\allocations\FTC Allocation Table.csv", "CSV", 0, 10, 0, 1, 11
"c:\Users\MichaelPerkins\OneDrive - Nomi Health, Inc\Desktop\Projects\financial_dashboard_v3\data\2023\allocations\FTE & Open Roles Allocation Table.csv", "CSV", 0, 16, 0, 1, 17
"c:\Users\MichaelPerkins\OneDrive - Nomi Health, Inc\Desktop\Projects\financial_dashboard_v3\data\2023\allocations\Pro Serv Allocation Table.csv", "CSV", 0, 16, 0, 1, 17
"c:\Users\MichaelPerkins\OneDrive - Nomi Health, Inc\Desktop\Projects\financial_dashboard_v3\data\2023\allocations\Software Allocation Table.csv", "CSV", 0, 86, 0, 1, 87
"c:\Users\MichaelPerkins\OneDrive - Nomi Health, Inc\Desktop\Projects\financial_dashboard_v3\data\2023\analysis\Actuals (Analysis).csv", "CSV", 0, 19363, 0, 1, 19364
"c:\Users\MichaelPerkins\OneDrive - Nomi Health, Inc\Desktop\Projects\financial_dashboard_v3\data\2023\analysis\Software (Analysis).csv", "CSV", 0, 191, 0, 1, 192
"c:\Users\MichaelPerkins\OneDrive - Nomi Health, Inc\Desktop\Projects\financial_dashboard_v3\data\2023\monthly\Actuals.csv", "CSV", 0, 19794, 0, 1, 19795
"c:\Users\MichaelPerkins\OneDrive - Nomi Health, Inc\Desktop\Projects\financial_dashboard_v3\data\2023\monthly\FTC Projections.csv", "CSV", 0, 89, 0, 1, 90
"c:\Users\MichaelPerkins\OneDrive - Nomi Health, Inc\Desktop\Projects\financial_dashboard_v3\data\2023\monthly\FTE Projections.csv", "CSV", 0, 139, 0, 1, 140
"c:\Users\MichaelPerkins\OneDrive - Nomi Health, Inc\Desktop\Projects\financial_dashboard_v3\data\2023\monthly\Open Roles Projections.csv", "CSV", 0, 106, 0, 1, 107
"c:\Users\MichaelPerkins\OneDrive - Nomi Health, Inc\Desktop\Projects\financial_dashboard_v3\data\2023\monthly\Pro Serv Projections.csv", "CSV", 0, 95, 0, 1, 96
"c:\Users\MichaelPerkins\OneDrive - Nomi Health, Inc\Desktop\Projects\financial_dashboard_v3\data\2023\monthly\Software Projections.csv", "CSV", 0, 154, 0, 1, 155
"c:\Users\MichaelPerkins\OneDrive - Nomi Health, Inc\Desktop\Projects\financial_dashboard_v3\data\2023\quarterly\Actuals (Quarterly).csv", "CSV", 0, 19363, 0, 1, 19364
"c:\Users\MichaelPerkins\OneDrive - Nomi Health, Inc\Desktop\Projects\financial_dashboard_v3\data\2023\quarterly\FTC Projections (QUARTERLY).csv", "CSV", 0, 89, 0, 1, 90
"c:\Users\MichaelPerkins\OneDrive - Nomi Health, Inc\Desktop\Projects\financial_dashboard_v3\data\2023\quarterly\FTE Projections (QUARTERLY).csv", "CSV", 0, 139, 0, 1, 140
"c:\Users\MichaelPerkins\OneDrive - Nomi Health, Inc\Desktop\Projects\financial_dashboard_v3\data\2023\quarterly\Open Roles Projections (QUARTERLY).csv", "CSV", 0, 106, 0, 1, 107
"c:\Users\MichaelPerkins\OneDrive - Nomi Health, Inc\Desktop\Projects\financial_dashboard_v3\data\2023\quarterly\Pro Services Projections (QUARTERLY).csv", "CSV", 0, 95, 0, 1, 96
"c:\Users\MichaelPerkins\OneDrive - Nomi Health, Inc\Desktop\Projects\financial_dashboard_v3\data\2023\quarterly\Software Projections (QUARTERLY).csv", "CSV", 0, 154, 0, 1, 155
"c:\Users\MichaelPerkins\OneDrive - Nomi Health, Inc\Desktop\Projects\financial_dashboard_v3\data\FTE Projections.csv", "CSV", 0, 139, 0, 1, 140
"c:\Users\MichaelPerkins\OneDrive - Nomi Health, Inc\Desktop\Projects\financial_dashboard_v3\data\output\Output.csv", "CSV", 0, 193, 0, 1, 194
"c:\Users\MichaelPerkins\OneDrive - Nomi Health, Inc\Desktop\Projects\financial_dashboard_v3\scripts\_main_.py", "Python", 51, 0, 10, 14, 75
"c:\Users\MichaelPerkins\OneDrive - Nomi Health, Inc\Desktop\Projects\financial_dashboard_v3\scripts\clean_actuals.py", "Python", 58, 0, 24, 20, 102
"c:\Users\MichaelPerkins\OneDrive - Nomi Health, Inc\Desktop\Projects\financial_dashboard_v3\scripts\clean_actuals_fte.py", "Python", 20, 0, 5, 6, 31
"c:\Users\MichaelPerkins\OneDrive - Nomi Health, Inc\Desktop\Projects\financial_dashboard_v3\scripts\clean_allocation_sheet.py", "Python", 53, 0, 25, 15, 93
"c:\Users\MichaelPerkins\OneDrive - Nomi Health, Inc\Desktop\Projects\financial_dashboard_v3\scripts\clean_data.py", "Python", 9, 0, 8, 4, 21
"c:\Users\MichaelPerkins\OneDrive - Nomi Health, Inc\Desktop\Projects\financial_dashboard_v3\scripts\complete_data_import.py", "Python", 10, 0, 8, 2, 20
"c:\Users\MichaelPerkins\OneDrive - Nomi Health, Inc\Desktop\Projects\financial_dashboard_v3\scripts\constants.py", "Python", 123, 0, 15, 15, 153
"c:\Users\MichaelPerkins\OneDrive - Nomi Health, Inc\Desktop\Projects\financial_dashboard_v3\scripts\detect_environment.py", "Python", 8, 0, 2, 2, 12
"c:\Users\MichaelPerkins\OneDrive - Nomi Health, Inc\Desktop\Projects\financial_dashboard_v3\scripts\format_cash_view.py", "Python", 14, 0, 4, 5, 23
"c:\Users\MichaelPerkins\OneDrive - Nomi Health, Inc\Desktop\Projects\financial_dashboard_v3\scripts\get_actuals_date.py", "Python", 7, 0, 3, 2, 12
"c:\Users\MichaelPerkins\OneDrive - Nomi Health, Inc\Desktop\Projects\financial_dashboard_v3\scripts\get_data.py", "Python", 9, 0, 5, 3, 17
"c:\Users\MichaelPerkins\OneDrive - Nomi Health, Inc\Desktop\Projects\financial_dashboard_v3\scripts\get_data_from_domo.py", "Python", 3, 0, 4, 0, 7
"c:\Users\MichaelPerkins\OneDrive - Nomi Health, Inc\Desktop\Projects\financial_dashboard_v3\scripts\get_data_from_either.py", "Python", 10, 0, 4, 2, 16
"c:\Users\MichaelPerkins\OneDrive - Nomi Health, Inc\Desktop\Projects\financial_dashboard_v3\scripts\get_data_from_local.py", "Python", 6, 0, 4, 1, 11
"c:\Users\MichaelPerkins\OneDrive - Nomi Health, Inc\Desktop\Projects\financial_dashboard_v3\scripts\get_date_from_string.py", "Python", 10, 0, 6, 4, 20
"c:\Users\MichaelPerkins\OneDrive - Nomi Health, Inc\Desktop\Projects\financial_dashboard_v3\scripts\join_name_map_to_actuals.py", "Python", 26, 0, 15, 16, 57
"c:\Users\MichaelPerkins\OneDrive - Nomi Health, Inc\Desktop\Projects\financial_dashboard_v3\scripts\print_columns.py", "Python", 7, 0, 7, 2, 16
"c:\Users\MichaelPerkins\OneDrive - Nomi Health, Inc\Desktop\Projects\financial_dashboard_v3\scripts\remove_string_from_column.py", "Python", 11, 0, 4, 7, 22
"c:\Users\MichaelPerkins\OneDrive - Nomi Health, Inc\Desktop\Projects\financial_dashboard_v3\scripts\setup_data_validation.py", "Python", 27, 0, 12, 9, 48
"c:\Users\MichaelPerkins\OneDrive - Nomi Health, Inc\Desktop\Projects\financial_dashboard_v3\scripts\setup_data_validation_actuals.py", "Python", 31, 0, 15, 10, 56
"c:\Users\MichaelPerkins\OneDrive - Nomi Health, Inc\Desktop\Projects\financial_dashboard_v3\scripts\setup_data_validation_ftc.py", "Python", 9, 0, 5, 3, 17
"c:\Users\MichaelPerkins\OneDrive - Nomi Health, Inc\Desktop\Projects\financial_dashboard_v3\scripts\setup_data_validation_fte.py", "Python", 9, 0, 6, 4, 19
"c:\Users\MichaelPerkins\OneDrive - Nomi Health, Inc\Desktop\Projects\financial_dashboard_v3\scripts\setup_data_validation_orm.py", "Python", 9, 0, 5, 3, 17
"c:\Users\MichaelPerkins\OneDrive - Nomi Health, Inc\Desktop\Projects\financial_dashboard_v3\scripts\setup_data_validation_pro_serv.py", "Python", 9, 0, 5, 3, 17
"c:\Users\MichaelPerkins\OneDrive - Nomi Health, Inc\Desktop\Projects\financial_dashboard_v3\scripts\setup_data_validation_software.py", "Python", 9, 0, 5, 3, 17
"c:\Users\MichaelPerkins\OneDrive - Nomi Health, Inc\Desktop\Projects\financial_dashboard_v3\scripts\write_data.py", "Python", 5, 0, 2, 0, 7
"Total", "-", 18442, 60530, 6320, 2820, 88112